NO ./textures/squared/flower.xpm
SO ./textures/squared/morrocan.xpm
WE ./textures/squared/inward-spiral.xpm
EA ./textures/squared/tile.xpm


F  220,100,100

C 225, 130,100



11111
11111
10011
1N0111
1111