
EA ./textures/Wall_East.png
NO ./textures/Wall_North.png
SO ./textures/Wall_South.png
WE ./textures/Wall_West.png

S tests/textures/enemy.xpm

F 220,111.1190
C 225,111.255



     11111
    100S001
     10001
      101
       1