NO  ./textures/BrickOv.xpm
SO ./textures/Bricks.xpm
WE ./textures/coal.xpm
EA ./textures/Dirt.xpm

F 100,197,170
C 197,131,100


111111111111
111000000011
   10000000011
1110N0000111
1000100001
10000100001
11111 11111