NO ./textures/cyan.xpm

SO ./texres/orange.xpm
WE ./textures/red.xmpm
      EA ./textures/blue.xpm

F 23,54,65

C 34,65,2

11111111
00000000
00000000
00000000