NO ./textures/BrickOv.xpm
SO ./textures/Bricks.xpm
WE ./textures/coal.xpm
EA ./textures/Dirt.xpm

F 100,197,170
C 197,131,100



        1111111111111111111111111
        1000000000110000000000001
        1011000001110000001000001
        1001000000000000000000001
111111111011000001110000000000001
100000000011000001110111110111111
11110111111111011100000000001
11110111111111011101010000001
11000000110101011100000000001
10001000000000001100000000001
10000000000000001101010000001
11000001110101011100000000N0111
11110111 1110101 100000010001
11111111 1111111 111111111111