NO ./textures/cyan.jpg
SO ./textures/orange.jpg
WE ./textures/red.jpg
EA ./textures/blue.jpg

F 23,54,4
C 34,23,1


   1111111111111111
 11111111111111111111
 111110000000000001111
   11111010001011W11
1110000111010101111

1111111111111111