NO ./textures/squared/flower.xpm
SO ./textures/squared/morrocan.xpm
WE ./textures/squared/inward-spiral.xpm
EA      ./textures/squared/tile.xpm


     F 150,150    ,200
   C 225,130, 200




        1111111111111111111111111
        1000000000110000000000001
        1011000001110000001000001
        1001000000000000000000001
111111111011000001110000000000001
100000000011000001110111110111111
11110111111111011100000000001
11110111111111011101010000001
11000000110101011100000000001
10001000000000001100000000001
10000000000000001101010000001
1100000111010101110000E0000111
11110111 1110101 100000010001
11111111 1111111 111111111111