NO ./textures/cyan.xpm
SO ./textures/orange.xpm

      EA ./textures/blue.xpm
WE ./textures/red.xpm

F 220,100,0
C 225,30,0

1111111111111111111111111111111111111111111111111
1000000000000000000000000001000000000010000000001
1011111111111110111111111101011111111110111111001
1010000000000000000000000001000000000000000000001
1010111111111110101111110111111111111111000110101
1010100000000000100000000001000000000000000101101
1010101011101110101011110101111110101010111110101
1010101000101000100000000100000000100010000010101
1000100000001010100000000000000000000010100000001
1E00111111101010100000000000000000000010101111111
1000100000001010000000000000000000000000100000001
1011101011111010100000000000000000000010101111111
1000101010001010100000000000000000000010000010101
1010101111101010101111011111111111111011111010101
1000100000001010000000000000000000001000101010001
1011111111111010111110111011101110111111101011101
1010101010101010111110111011101110110111110101011
1010101010101010000000000000000001010100010101011
1010101010101010111111111011111011111110101010111
1000000000000000000000000010000000000000000000011
1111111111111111111111111111111111111111111111111