NO ./textures/cyan.jpg
SO ./textures/orange.jpg
WE ./textures/red.jpg
EA ./textures/blue.jpg

F 23,54,4
C 34,23,1


    1111111111111111111111111
    1000000000110000000000001
    10000000001100000000N00111
111100000111000000000000001
10010000000000000000000000011111
111111111011000001110000000000001
1111100000011000001110111111111111
    111110111111110111000000111
11110111111111011101010010001
11000000110101011100000000001
1000000000000000110000010001
1000000000000001100000010001
100000000000000011010100100011111
110000011101010111110111100000001
11110111 1110101 1 1111 10001111
11111111 1111111 111111111111 111  